1111111111
10000000E1
10C0000001
1000000001
1001111101
1001000001
1001000001
1001000001
10C00000P1
1111111111