1111111111
1E00000001
1000000001
1000000001
1001100001
1001001001
100101C001
1001000001
10C00000P1
1111111111