1111111111
1000PCE001
1111111111