1111111111
10000PCE11
1111111111