1111111111
1000000001
11110E0001
1000000001
1001100001
10010C1001
1001010001
1001000011
10000000P1
1111111111