1111111111
1000000001
11110E0001
100000P001
1001100001
1001001001
100CC10001
1001000011
1000000001
1111111111