1111111111
10C0P0E001
1000000001
1111111111