1111111111
1000PEC001
1000000001
1111111111