1111111111111111111
1000CP000000000C001
1000E00000000111111
111110000C000100011
1111100100010100011
100C00000C0000C0001
100C00000C0000C0001
100C00000C0000C0001
1111111111111111111